111111111
1101E1001
100000001
101C100P1
111111111
